/Map,,,,,//1=true,,,Door01,,destination,,Door02,,destination,,Door03,,destination,,Door04,,destination,
/x,y,width,height,maxUnit,startFlg,defenseFlg,mapDays,x,y,map,door,x,y,map,door,x,y,map,door,x,y,map,door
-300,-300,200,100,4,0,1,3,,,1,,,,-1,,,,-1,,,,-1,
-300,-100,200,100,4,0,0,3,,,0,,,,3,,,,-1,,,,-1,
-300,100,200,100,4,0,0,3,,,4,,,,-1,,,,-1,,,,-1,
0,-100,200,100,4,0,0,3,,,1,,,,4,,,,5,,,,-1,
0,100,200,100,4,0,0,3,,,2,,,,3,,,,-1,,,,-1,
300,-100,200,100,4,0,0,3,,,3,,,,6,,,,-1,,,,-1,
300,100,200,100,4,1,0,3,,,5,,,,-1,,,,-1,,,,-1,
